1111111111111
10010001C0001
1000011111C01
1P1011E0C0001
1111111111111
