11111111111111111111
10000100000000100001
10110101111110101E01
10000000000000000111
10101101100110110101
10101101111110110101
101000000P0000000101
1001C1C111111C1C1101
11111111111111111111
