1111111111111111
101P00000000E001
101C010100100001
101001C010101011
100C0C000C0000C1
1111111111111111
