1111111111111111
1010000000000001
1010010100100001
1010010010101011
1000P0000C000EC1
1111111111111111
