11111111111111111111
101P00000000E0000001
101C0101001000000001
101001C0101010100001
100C0C000C0000C00001
100C0C000C0000C00001
100C0C000C0000C00001
100C0C000C0000C00001
100C0C000C0000C00001
100C0C000C0000C00001
100C0C000C0000C00001
100C0C000C0000C000C1
11111111111111111111
