1111111111111111
101P00000000E001
1010010100100001
1010010010101011
100000000C0000C1
1111111111111111
