11111111111111111111111111111111111111111
1P00000000000000000CC0000000000000C0000C1
1C000000000000C00000000000C1111C111111C11
1ECC0000000000000000000011101010101010101
11111111111111111111111111111111111111111
